шаманить	шаманем
кадра	кадрой	кадры
хлебало	хлебала
мясо	мяс
полный	полн
просо	прос
брус	брусов
обличье	обличью
окоротить	окоротись
пережабина	пережабинами	пережабину	пережабины	пережабинах	пережабиной
пестрина	пестринах
подданный	подданные	подданных
борзый	борзей
брызги	брызгов
бус	бусом	буса	бусов
елань	еланям
жемчуг	жемчуги
каракуля	каракуль
латы	лат
форсированный	форсированных	форсированными	форсированная	форсированной
цыпки	цыпках	цыпками
шикарный	шикарнейшая
разводы	разводах	разводами
